##########
#    X   #
#        #
###%%#####
#b   gC  #
#  C g   #
#    g  X#
#   ######
#E t#t m #
##########