##########
#b  X  OX#
#        #
#  CO    #
#  PO    #
#  gg  # #
#  C   #C#
# %%% O# #
# %X% m#E#
##########
