OOOOOOOOOO
OOOOOOOOOO
##########
#t   X X #
#      # #
#E   C C #
######  t#
OOOOO#####
OOOOOOOOOO
OOOOOOOOOO
