##########
#b%X%   X#
# %%%   g#
#   C   g#
# C     g#
#      # #
# #Pp  #C#
#m  O ## #
# #X# b#E#
##########
