###############
#m t#   #     #
#  C#     P   #
#   %         #
#####   p###  #
#    OO ##X   #
#  p O ##     #
#  #   #    ###
#     ##     b#
# g X##   #  E#
# g###    #####
# g       %   #
# tggg    %C  #
#         %   #
###############